c0c0c0c0c0c0c0c0c0c0c0c0c0c0c0c0c0c0c0c0c0c0c0c0c0c0c0c0c0c0c0c0c0c0c0c0c0c0c0c0c0c0c0c0c0c0c0c0c0c0c0c0000000000000000000000000
c0c0c0c0c0c0c0c0c0c0c0c0c0c0c0c0c0c0c0c0c0c0c0c0c0c0c0c0c0c0c0c0c0c0c0c0c0c0c0c0c0c0c0c0c0c0c0c0c0c0c0c0000000000000000000000000
c0c0c0c0c0c0c0c0c0c0c0c0c0c0c0c0c0c0c0c0c0c0c0c0c0c0c0c0c0c0c0c0c0c0c0c0c0c0c0c0c0c0c0c0c0c0c0c0c0c0c0c0000000000000000000000000
c0c0c0c0c0c0c0c0c0c0c0c0c0c0c0c0c0c0c0c0c0c0c0c0c0c0c0c0c0c0c0c0c0c0c0c0c0c0c0c0c0c0c0c0c0c0c0c0c0c0c0c0000000000000000000000000
c0c0c0c0c0c0c0c0c0c0c0c0c0c0c0c0c0c0c0c0c0c0c0c0c0c0c0c0c0c0c0c0c0c0c0c0c0c0c0c0c0c0c0c0c0c0c0c0c0c0c0c0000000000000000000000000
c0c0c0c0c0c0c0c0c0c0c0000000c0c0c0c0c0c0c0c0c0c0c0c0c0c0c0c0c0c0c0c0c0c0c0c0c0c0c0c0c0c0c0c0c0c0c0c0c0c0000000000000000000000000
c0c0c0c0c0c0c0c0c0c00000000000c0c0c0c0c0c0c0c0c0c0c0c0c0c0c0c0c0c0c0c0c0c0c0c0c0c0c0c0c0c0c0c0c0c0c0c0c0000000000000000000000000
c0c0c000000000000000c0000000c0d8000000000000c0c0c0c0c0c0c0c0c0c0c0c0c0c0c0c0c0c0c0c0c0c0c0c0c0c0c0c0c0c0000000000000000000000000
c0c0c000000000000000c0000000c000000000000000c0c0c0c0c0c0c0c0c0c0c0c0c0c0c0c0c0c0c0c0c0c0c0c0c0c0c0c0c0c0000000000000000000000000
c0c0c000000000000000000000000000000000000000c0c0c0c0c0c0c0c0c0c0c0c0c0c0c0c0c0c0c0c0c0c0c0c0c0c0c0c0c0c0000000000000000000000000
c0c0c0000000c00000000000000000000000c0000000c0c0c0c0c0c0c0c0c0c0c0c0c0c0c0c0c0c0c0c0c0c0c0c0c0c0c0c0c0c0000000000000000000000000
c0c0c0000000c00000000000000000000000c0000000c0c0c0c0c0c0c0c0c0c0c0c0c0c0c0c0c0c0c0c0c0c0c0c0c0c0c0c0c0c0000000000000000000000000
c0c0c0000000c0c0c0c0c0000000c0c0c0c0c0000000c0c0c0c0c0c0c0c0c0c0c0c0c0c0c0c0c0c0c0c0c0c0c0c0c0c0c0c0c0c0000000000000000000000000
c0c0c0000000c0c0c0c0c0000000c0c0c0c0c0000000c0c0c0c0c0c0c0c0c0c0c0c0c0c0c0c0c0c0c0c0c0c0c0c0c0c0c0c0c0c0000000000000000000000000
c0c0c0000000c0c0c0c0c000000000c0c0c0c0000000c0c0c0c0c0c0c0c0c0c0c0c0c0c0c0c0c0c0c0c0c0c0c0c0c0c0c0c0c0c0000000000000000000000000
c0c0c0000000c0c0c0c0c0000000c0c0c0c0c0000000c0c0c0c0c0c0c0c0c0c0c0c0c0c0c0c0c0c0c0c0c0c0c0c0c0c0c0c0c0c0000000000000000000000000
c0c0c000000000000000c00000000000000000000000c0c0c0c0c0c0c0c0c0c0c0c0c0c0c0c0c0c0c0c0c0c0c0c0c0c0c0c0c0c0000000000000000000000000
c0c0c000000000000000c0000000c000000000000000c0c0c0c0c0c0c0c0c0c0c0c0c0c0c0c0c0c0c0c0c0c0c0c0c0c0c0c0c0c0000000000000000000000000
c0c0c000000000000000000000000000000000000000c0c0c0c0c0c0c0c0c0c0c0c0c0c0c0c0c0c0c0c0c0c0c0c0c0c0c0c0c0c0000000000000000000000000
c0c0c0000000c0c0000000000000000000c0c0000000c0c0c0c0c0c0c0c0c0c0c0c0c0c0c0c0c0c0c0c0c0c0c0c0c0c0c0c0c0c0000000000000000000000000
c0c0c00000c0c0c0c0c0c0000000c0c0c0c0c0000000c0c0c0c0c0c0c0c0c0c0c0c0c0c0c0c0c0c0c0c0c0c0c0c0c0c0c0c0c0c0000000000000000000000000
c0c0c000c000c0c0c0c0c0000000c0c0c0c0c0000000c0c0c0c0c0c0c0c0c0c0c0c0c0c0c0c0c0c0c0c0c0c0c0c0c0c0c0c0c0c0000000000000000000000000
c0c0c0000000c0c0c0c0c0000000c0c0c0c0c0c00000c0c0c0c0c0c0c0c0c0c0c0c0c0c0c0c0c0c0c0c0c0c0c0c0c0c0c0c0c0c0000000000000000000000000
c0c0c0000000c0c0c0c0c0c00000c0c0c0c000c00000c0c0c0c0c0c0c0c0c0c0c0c0c0c0c0c0c0c0c0c0c0c0c0c0c0c0c0c0c0c0000000000000000000000000
c0c0c00000000000000000000000c000000000000000c0c0c0c0c0c0c0c0c0c0c0c0c0c0c0c0c0c0c0c0c0c0c0c0c0c0c0c0c0c0000000000000000000000000
c0c0c000000000000000000000000000000000000000c0c0c0c0c0c0c0c0c0c0c0c0c0c0c0c0c0c0c0c0c0c0c0c0c0c0c0c0c0c0000000000000000000000000
c0c0c0c0c0c0c0c0c0c0c0000000c0c0c0c0c0c0c0c0c0c0c0c0c0c0c0c0c0c0c0c0c0c0c0c0c0c0c0c0c0c0c0c0c0c0c0c0c0c0000000000000000000000000
c0c0c0c0c0c0c0c0c0c0c0000000c0c0c0c0c0c0c0c0c0c0c0c0c0c0c0c0c0c0c0c0c0c0c0c0c0c0c0c0c0c0c0c0c0c0c0c0c0c0000000000000000000000000
c0c0c0c0c0c0c0c0c0c0c0000000c0c0c0c0c0c0c0c0c0c0c0c0c0c0c0c0c0c0c0c0c0c0c0c0c0c0c0c0c0c0c0c0c0c0c0c0c0c0000000000000000000000000
c0c0c0c0c0c0c0c0c0c0c0000000c0c0c0c0c0c0c0c0c0c0c0c0c0c0c0c0c0c0c0c0c0c0c0c0c0c0c0c0c0c0c0c0c0c0c0c0c0c0000000000000000000000000
c0c0c0c0c0c0c0c0c0c0c0000000c0c0c0c0c0c0c0c0c0c0c0c0c0c0c0c0c0c0c0c0c0c0c0c0c0c0c0c0c0c0c0c0c0c0c0c0c0c0000000000000000000000000
c0c0c0c0c0c0c0c0c0c0c0101010c0c0c0c0c0c0c0c0c0c0c000000000000000000000000000000000000000000000000000c0c0000000000000000000000000
c0c0c0c0c0c0c0c0c0c0c0000000c0c0c0c0c0c0c0c0c0c0c0000000000000000000000000000000000000000000000000000000000000000000000000000000
c0c0c0c0c0c0c0c0c0c0c0c0c0c0c0c0c0c0c0c0c0c0c0c0c0c0c0c0c0c0c0c0c0c0c0c0c0c0c0c0c0c0c0c0c0c0c0c0c0c00000000000000000000000000000
c0c0c0c0c0c0c0c0c0c0c0c0c0c0c0c0c0c0c0c0c0c0c0c0c0c0c0c0c0c0c0c0c0c0c0c0c0c0c0c0c0c0c0c0c0c0c0c0c0c00000000000000000000000000000
c0c0c0c0c0c0c0c0c0c0c0c0c0c0c0c0c0c0c0c0c0c0c0c0c0c0c0c0c0c0c0c0c0c0c0c0c0c0c0c0c0c0c0c0c0c0c0c0c0c00000000000000000000000000000
c0c0c0c0c0c0c0c0c0c0c0c0c0c0c0c0c0c0c0c0c0c0c0c0c0c0c0c0c0c0c0c0c0c0c0c0c0c0c0c0c0c0c0c0c0c0c0c0c0c00000000000000000000000000000
c0c0c0c0c0c0c0c0c0c0c0c0c0c0c0c0c0c0c0c0c0c0c0c0c0c0c0c0c0c0c0c0c0c0c0c0c0c0c0c0c0c0c0c0c0c0c0c0c0c00000000000000000000000000000
c0c0c0c0c0c0c0c0c0c0c0000000c0c0c0c0c0c0c0c0c0c0c0c0c0c0c0c0c0c0c0c0c0c0000000c0c0c0c0c0c0c0c0c0c0c00000000000000000000000000000
c0c0c0c0c0c0c0c0c0c00000000000c0c0c0c0c0c0c0c0c0c0c0c0c0c0c0c0c0c0c0c00000000000c0c0c0c0c0c0c0c0c0c00000000000000000000000000000
c0c0c000000000000000c0000000c0c0000000000000c0c0c0c0c0c00000c000c0c000c0000000c0c00000c000c000c0c0c00000000000000000000000000000
c0c0c000000000000000c0000000c000000000000000c0c0c0c0c0c0000000c0c00000c0000000c000000000000000c0c0c00000000000000000000000000000
c0c0c000000000000000000000000000000000000000c0c0c0c0c0c000000000000000000000000000000000000000c0c0c00000000000000000000000000000
c0c0c0000000c00000000000000000000000c0000000c0c0c0c0c0c0000000c00000000000000000000000c0000000c0c0c00000000000000000000000000000
c0c0c0000000c00000000000000000000000c0000000c0c0c0c0c0c0000000c00000000000000000000000c0000000c0c0c00000000000000000000000000000
c0c0c0000000c0c0c0c0c0000000c0c0c0c0c0000000c0c0c0c0c0c0000000c0c0c0c0c0000000c0c0c0c0c0000000c0c0c00000000000000000000000000000
c0c0c0000000c0c0c0c0c0000000c0c0c0c0c0000000c0c0c0c0c0c0000000c0c0c0c0c0000000c0c0c0c0c0000000c0c0c00000000000000000000000000000
c0c0c0000000c0c0c0c0c000000000c0c0c0c0000000c0c0c0c0c0c0000000c0c0c0c0c0000000c0c0c0c0c0000000c0c0c00000000000000000000000000000
c0c0c0000000c0c0c0c0c0000000c0c0c0c0c0000000c0c0c0c0c0c0000000c0c0c0c0c0000000c0c0c0c0c0000000c0c0c00000000000000000000000000000
c0c0c000000000000000c0000000c000000000000000c0c0c0c0c0c000000000000000c0000000c00000000000c000c0c0c00000000000000000000000000000
c0c0c000000000000000c0000000c000000000000000c0c0c0c0c0c000000000000000c0c0c0c0c000000000000000c0c0c00000000000000000000000000000
c0c0c00000000000000000c0c0c0c000000000000000c0c0c0c0c0c00000000000000000000000000000c0c0000000c0c0c00000000000000000000000000000
c0c0c0000000c0c0000000000000000000c0c0000000c0c0c0c0c0c0000000c0c0000000000000000000c0c0000000c0c0c00000000000000000000000000000
c0c0c00000c0c0c0c0c0c0000000c0c0c0c0c0000000c0c0c0c0c0c00000c0c0c0c0c0c0000000c0c0c0c0c0000000c0c0c00000000000000000000000000000
c0c0c000c000c0c0c0c0c0000000c0c0c0c0c0000000c0c0c0c0c0c000c000c0c0c0c0c0000000c0c0c0c0c0000000c0c0c00000000000000000000000000000
c0c0c0000000c0c0c0c0c0000000c0c0c0c0c0c00000c0c0c0c0c0c0000000c0c0c0c0c0000000c0c0c0c0c0000000c0c0c00000000000000000000000000000
c0c0c0000000c0c0c0c0c0c00000c0c0c0c000c00000c0c0c0c0c0c0000000c0c0c0c0c0c00000c0c0c00000c00000c0c0c00000000000000000000000000000
c0c0c00000000000000000000000c000000000000000c0c0c0c0c0c00000000000000000000000c000c0c000000000c0c0c00000000000000000000000000000
c0c0c000000000000000000000000000000000000000c0c0c0c0c0c00000000000000000000000000000c000000000c0c0c00000000000000000000000000000
c0c0c0c0c0c0c0c0c0c0c0000000c0c0c0c0c0c0c0c0c0c0c0c0c0c0c0c0c0c0c0c0c0c0000000c0c0c0c0c0c0c0c0c0c0c00000000000000000000000000000
c0c0c0c0c0c0c0c0c0c0c0000000c0c0c0c0c0c0c0c0c0c0c0c0c0c0c0c0c0c0c0c0c0c0000000c0c0c0c0c0c0c0c0c0c0c00000000000000000000000000000
c0c0c0c0c0c0c0c0c0c0c0000000c0c0c0c0c0c0c0c0c0c0c0c0c0c0c0c0c0c0c0c0c0c0000000c0c0c0c0c0c0c0c0c0c0c00000000000000000000000000000
c0c0c0c0c0c0c0c0c0c0c0000000c0c0c0c0c0c0c0c0c0c0c0c0c0c0c0c0c0c0c0c0c0c0000000c0c0c0c0c0c0c0c0c0c0c00000000000000000000000000000
c0c0c0c0c0c0c0c0c0c0c0000000c0c0c0c0c0c0c0c0c0c0c0c0c0c0c0c0c0c0c0c0c0c0000000c0c0c0c0c0c0c0c0c0c0c00000000000000000000000000000
